111111
1CP001
1Ca001
110E01
1C0001
111111
