111111
1000C1
10P001
10E001
10C001
111111
