111111
1CP001
1C0001
110E01
1CX001
111111
