1111111
10C0001
100P001
1C000E1
1111111
