1111111
10CC001
1C00E11
100P001
1C110E1
1C10E11
1111111
