1111111
10C0001
1C00E11
100P001
1C000E1
1C00E11
1111111
