111111
10XCP1
1X0001
1E0001
111111
100001
111111
