111111111
10C00P001
100000001
1100E0001
1C1000001
111111111
