111111
1CP001
1X0001
110E01
1C0001
111111
